666666666666666666666-
614141414141414141416-
646464646464646464646-
614141414141414141416-
646464646464646464646-
614141414141414141416-
646464646464646464646-
614141414141414141416-
641414141414141414146-
666666666666666666666
