666666666666666666-
641414141414141416-
644646464646464646-
641414141414141416-
644646464646464646-
641414141414141416-
644646464646464646-
641414141414141416-
614141414141414146-
666666666666666666
