666666666666666666-
611111111111111116-
616666611116666616-
611111611116111116-
611114411114411116-
611114411114411116-
611111611116111116-
616666611116666616-
611111111111111116-
666666666666666666
