666666666666666666666-
644411111111111114446-
646411111111111114646-
644411111111111114446-
611111111111111111116-
611111111111111111116-
644411111111111114446-
646411111111111114646-
644411111111111114446-
666666666666666666666
