666666666666666666666-
611111111111111111116-
616666661111166666616-
611111161111161111116-
611111441111144111116-
611111441111144111116-
611111161111161111116-
616666661111166666616-
611111111111111111116-
666666666666666666666
